4
0002022020000
0111212101110
2100000000012
2101110111012
0001020201220
2121210101012
2122020200000
0121010121111
0100020202020
0111212121210
0000000300000