60
5
400001002200
010101210102
000102001220
010121312101
220200000202
020200020202
010121012121
000202202000
012111111210
010220022010
201002110201
002100120122