60
4
400202202004
011121210111
210000000001
210111011101
000102020122
212121010101
212202020000
012101012111
010002020202
011121212121
021020030000
400210000024